212121212121212121212121212121212121212121212121212121212121212121212121212121212121212121212121212121212121212121212121
212121212121212121212121212121212121212121212121212121212121212121212121212121212121212121212121212121212121212121212121
212121212121212121212121212121212121212121212121212121212121212121212121212121212121212121212121212121212121212121212121
212121212121212121212121212121212121212121212121212121212121212121212121212121212121212121212121212121212121212121212121
212121212121212121212121212121212121212121212121212121212121212121212121212121212121212121212121212121212121212121212121
212121212121212121212121212121212121212121212121212121212121212121212121212121212121212121212121212121212121212121212121
212121212121212121212121212121212121212121212121212121212121212121212121212121212121212121212121212121212121212121212121
212121212121212121212121212121212121212121212121212121212121212121212121212121212121212121212121212121212121212121212121
212121212121212121212121212121212121133131313131313131313131313131313114212121212121212121212121212121212121212121212121
212121212121212121212121133131313131320000000000000100000000000000000030313131313114212121212121212121212121212121212121
212121212121212121212121220000000000000000000000000001000000000000000000000100000020212121212121212121212121212121212121
212121212121212121212121220010111111120000000000001012000000000000000010111112000030313131313114212121212121212121212121
212121212121212121212121220020212121231111114011112423114011111200000020212122000000000000000020212121212121212121212121
212121212121212121212121220020212121211331315031313131315031142200000020212122000015161617000020212121212121212121212121
212121212121212121212121220120212121212200000000000100000000202311401124212122000025262627000020212121212121212121212121
212121212121212121212121220020212121212200000000000100000000201331503131142155000035050437000020212121212121212121212121
212121212121212121212121220020212121212200000000000100000000202200000000202122000000000000000020212121212121212121212121
212121212121212121212121220020212121212200000000000101010101202200000000202122000000000000000020212121212121212121212121
212121212121211331313131320030313114212200000000000000000200202200000000202122000000000000000020212121212121212121212121
212121212121212200000000000000000020212200000000000000000000425200000000202123120010111111111124212121212121212121212121
212121212121212200000000000000000020212200000000000000000000202200000000202121220020212121212121212121212121212121212121
212121212121212200001516161617000020212200000000000000000000202311111111242121220020212121212121212121212121212121212121
212121212121212200002526262627000054212201101111441111111111242121212121212121220120212121212121212121212121212121212121
212121212121212200003505040537000020212201202121212121212121212121212121212121220020212121212121212121212121212121212121
212121212121212200000000000000000020212201202121212121212121212121212121212121220020212121212121212121212121212121212121
212121212121212200000000000000000020212201202121212121212121133131453131313131320020212121212121212121212121212121212121
212121212121212200000000000000000030313201303131313131313131320000000000000000000020212121212121212121212121212121212121
212121212121212311111111111111120000000000000001000000000000000000151616161700001024212121212121212121212121212121212121
212121212121212121212121212121231111111111111111111111111111120000252626262700002021212121212121212121212121212121212121
212121212121212121212121212121212121212121212121212121212121220000353606043700002021212121212121212121212121212121212121
212121212121212121212121212121212121212121212121212121212121220000000000000000002021212121212121212121212121212121212121
212121212121212121212121212121212121212121212121212121212121220000000000000000002021212121212121212121212121212121212121
212121212121212121212121212121212121212121212121212121212121231111111111111111112421212121212121212121212121212121212121
212121212121212121212121212121212121212121212121212121212121212121212121212121212121212121212121212121212121212121212121
212121212121212121212121212121212121212121212121212121212121212121212121212121212121212121212121212121212121212121212121
212121212121212121212121212121212121212121212121212121212121212121212121212121212121212121212121212121212121212121212121
212121212121212121212121212121212121212121212121212121212121212121212121212121212121212121212121212121212121212121212121
212121212121212121212121212121212121212121212121212121212121212121212121212121212121212121212121212121212121212121212121
212121212121212121212121212121212121212121212121212121212121212121212121212121212121212121212121212121212121212121212121
212121212121212121212121212121212121212121212121212121212121212121212121212121212121212121212121212121212121212121212121

image image:village
song song:main
hero @25,19
sprite @28,20 sprite:king battle:king (u16:flag)false
flagtile @22,13 (u16:flag)bridge1
flagtile @22,12 (u16:flag)bridge1
flagtile @28,13 (u16:flag)bridge2
flagtile @33,15 (u16:flag)bridge3
flagtile @31,19 (u16:flag)bridge4
flagtile @30,19 (u16:flag)bridge4
flagtile @33,14 (u16:flag)bridge3
flagtile @28,12 (u16:flag)bridge2
flagtile @28,18 (u16:flag)bridge4
toggle @28,18 (u16:flag)bridge4
